{
    Custom CSS Link: Link CSS personalizado,
    Google font link: Link da fonte do Google,
    Main Container:  Contêiner Principal,
    text color: Cores do texto,
    Variables: Variáveis,
    Background Colors: Cores de fundo,
    Text Colors: Cores do texto,
    Font Size: Tamanho da fonte,
    Others: Outros,
    custom scrollbar style: estilo de barra de rolagem personalizado,
    Reset & Default Style: Redefinir & estilo padrão,
    main container: recipiente principal,
    mobile navbar style: 
    navbar: barra de navegação,
    About: Sobre,
    social link: link social,
    sidebar footer: rodapé da barra lateral,
    about section structure: sobre a estrutura da seção,
    about section hero structure:sobre a estrutura do herói da seção.
    sidebar structure style: estilo de estrutura da barra lateral,
    navbar style: estilo da barra de navegação,
    social link style: estilo de link social,
    about section structure style: sobre o estilo da estrutura da seção,
    wrapper: embutido,
    Web Developer: Desenvolvedor Web:,
    about section hero structure style: sobre o estilo da estrutura do herói da seção,
    about section service structure style: sobre o estilo de estrutura de serviço de seção,
    about section service structure: sobre a estrutura de serviço da seção,
    What i do: O que eu faço,
    Ecommerce: Comércio eletrônico,
    about section testimonials structure: sobre a estrutura de depoimentos da seção,
    about section testimonials structure style: "sobre o estilo de estrutura de depoimentos de seção",
    Testimonials: "Depoimentos",
    about section clients structure style: "sobre o estilo da estrutura dos clientes da seção",

}